011111111111110001111111110101111111140000001111100010100011101010201011100011000011101000011111130010001111111110101111111110001111111111111111
111111111111111111111111111400000111111032230111111050320111111053020111111050320111111030030111111111111111111111111111111111111111111111111111
111111111111111111111111111400000111111032250111111033230111111030530111111030230111111022220111111000000111111111111111111111111111111111111111
111111111111111111111111111110001111111110001111113500011111110210011111114010011111111111111111111111111111111111111111111111111111111111111111
111111111111111111111111111111000111111102224111111133301111111100001111111111111111111111111111111111111111111111111111111111111111111111111111
111110011111111114000001111100011001033101011011000002001211100101000011111100011211111111111001111130000001111111111111111111111111111111111111
111111111111111111111111111330433111111002220111111111011111111000000011111000000011111000000011111000002011111001111111111111111111111111111111
111111111111111111111111111111111111111104311111111022501111111001301111111000001111111021001111111100311111111111111111111111111111111111111111
111111111111111100000111111000020111110201111111110224201111110000000111111111000111113011100111113031100111110000000111111303001111111111111111
111111111111111111111111111003001111110003000111110213120011110200020011111111110011110001110011110232320011111034300111111111111111111111111111
111111111111111111111111111111111111111103011111111005001111111022201111111035301111111104011111111111111111111111111111111111111111111111111111
111111111111111111111111111001111111111052011111111031011111111050011111110054011111110001111111111111111111111111111111111111111111111111111111
111111111111111111111111111001001111111020401111111055501111111010501111111030001111111111111111111111111111111111111111111111111111111111111111
111111111111111111111111111140111111111122111111111000111111111313011111110505011111110000001111111110001111111111111111111111111111111111111111
111111111111111111111111111000011111111020211111111014201111111050101111111103301111111100311111111111111111111111111111111111111111111111111111
111111111111111104011111111023201111110355530111110023200111111000001111111100011111111111111111111111111111111111111111111111111111111111111111
111111111111111111111111111104011111111120211111111002011111111035300111111135300111111102001111111105011111111100111111111111111111111111111111
111111111111111133311111111100311111111100311111111110011111110000100011110224200011111011000111110202011111110000011111111111111111111111111111
111111111111111111111111111100011111111124211111110053500111110152510111110031300111110000000111110011111111111111111111111111111111111111111111
111111111111111111111111111100111111111120200111111103330011110223250011110325531111110004001111111111111111111111111111111111111111111111111111